NO ./texture/1.png


SO ./texture/2.png


WE ./texture/3.png


EA ./texture/4.png

F 100,100,100
C 50,50,50

1111111111111
1001000000001
1011000000101
1001000000001
1000111111101
1000000000001
11111 11111111
