NO ./texture/1.png
SO ./texture/2.png
WE ./texture/3.png
EA ./texture/4.png

F 220,100,100
C 255,0,0

1111111111111111111111111
1000000000110000000000001
1011000001110000000000001
1001000000000000000000001
1111111110110000011100001000000001
100000000011000001111111111111111
11110111111111011100000010001
11110111111111011101010010001
11000000110101011100000010001
10000000000000001100000010001
10000000000000001101011010001
11000001110101011111011N100111
1111011111101011011110111001
111111111111111111111111111
