


NO ./texture/1.png


SO ./texture/2.png


WE ./texture/3.png


EA ./texture/4.png

F 1,1,1


C 255,255,255


1111111111111
1000000000001
10W00000000011111
1111111111111
